  xxxxxxxxxxxxxxxxx
x   x             x 
xxx x xxxxxxxxxxx x 
x   x     x x   x x 
x xxx xxx x x x x x 
x   x x   x x x   x 
x x x x xxx x xxxxx 
x x x x   x x x     
x x xxx x x x xxx xx
x x     x   x       
xxxxxxxxxxxxxxxxxxx 
